111111111111111
1000000000001E1
100000000000101
100000000000101
100000000000101
100000000111101
1000000001C0001
100000000100111
100000000100101
100000000100111
100000000100001
100000000110001
100000000000001
100000000000001
100000000000P01
111111111111111